..............................
..............................
...A...............L..........
..............K.........M.....
..............................
...B......J.....I...........N.
......................P.......
.................H..Q...O.....
..C..D........................
...........F................T.
........E.....G.....R..S......
..............................
............................U.
._..^..................V......
.......\..[......X............
.`...]......Z..Y......W.......
